"filename", "language", "C++", "comment", "blank", "total"
"g:\_git\__ESP\esp-wifi_env_sensor\src\HAL_JSON\RuleEngine\HAL_JSON_RULE_Engine.cpp", "C++", -100, -3, -16, -119
"g:\_git\__ESP\esp-wifi_env_sensor\src\HAL_JSON\RuleEngine\HAL_JSON_RULE_Engine.h", "C++", -54, -16, -18, -88
"g:\_git\__ESP\esp-wifi_env_sensor\src\HAL_JSON\RuleEngine\HAL_JSON_RULE_Engine_ActionStatement.cpp", "C++", 5, 0, 3, 8
"g:\_git\__ESP\esp-wifi_env_sensor\src\HAL_JSON\RuleEngine\HAL_JSON_RULE_Engine_ActionStatement.h", "C++", 20, 0, 7, 27
"g:\_git\__ESP\esp-wifi_env_sensor\src\HAL_JSON\RuleEngine\HAL_JSON_RULE_Engine_CalcRPNToken.cpp", "C++", 171, 2, 9, 182
"g:\_git\__ESP\esp-wifi_env_sensor\src\HAL_JSON\RuleEngine\HAL_JSON_RULE_Engine_CalcRPNToken.h", "C++", 35, 6, 8, 49
"g:\_git\__ESP\esp-wifi_env_sensor\src\HAL_JSON\RuleEngine\HAL_JSON_RULE_Engine_IfBlock.cpp", "C++", 8, 0, 3, 11
"g:\_git\__ESP\esp-wifi_env_sensor\src\HAL_JSON\RuleEngine\HAL_JSON_RULE_Engine_IfBlock.h", "C++", 41, 19, 13, 73
"g:\_git\__ESP\esp-wifi_env_sensor\src\HAL_JSON\RuleEngine\HAL_JSON_RULE_Engine_IfConditionItem.cpp", "C++", 23, 0, 5, 28
"g:\_git\__ESP\esp-wifi_env_sensor\src\HAL_JSON\RuleEngine\HAL_JSON_RULE_Engine_IfConditionItem.h", "C++", 27, 1, 8, 36
"g:\_git\__ESP\esp-wifi_env_sensor\src\HAL_JSON\RuleEngine\HAL_JSON_RULE_Engine_LogicalExpressionRPNToken.cpp", "C++", 6, 0, 2, 8
"g:\_git\__ESP\esp-wifi_env_sensor\src\HAL_JSON\RuleEngine\HAL_JSON_RULE_Engine_LogicalExpressionRPNToken.h", "C++", 20, 1, 8, 29
"g:\_git\__ESP\esp-wifi_env_sensor\src\HAL_JSON\RuleEngine\HAL_JSON_RULE_Engine_RPNStack.cpp", "C++", 5, 0, 3, 8
"g:\_git\__ESP\esp-wifi_env_sensor\src\HAL_JSON\RuleEngine\HAL_JSON_RULE_Engine_RPNStack.h", "C++", 32, 0, 9, 41
"g:\_git\__ESP\esp-wifi_env_sensor\src\HAL_JSON\RuleEngine\HAL_JSON_RULE_Engine_Script.cpp", "C++", 8, 0, 4, 12
"g:\_git\__ESP\esp-wifi_env_sensor\src\HAL_JSON\RuleEngine\HAL_JSON_RULE_Engine_Script.h", "C++", 23, 14, 5, 42
"g:\_git\__ESP\esp-wifi_env_sensor\src\HAL_JSON\RuleEngine\HAL_JSON_RULE_Engine_StatementBlock_s.cpp", "C++", 10, 0, 5, 15
"g:\_git\__ESP\esp-wifi_env_sensor\src\HAL_JSON\RuleEngine\HAL_JSON_RULE_Engine_StatementBlock_s.h", "C++", 33, 4, 11, 48
"g:\_git\__ESP\esp-wifi_env_sensor\src\HAL_JSON\RuleEngine\HAL_JSON_RULE_Engine_Structures.cpp", "C++", -196, -3, -14, -213
"g:\_git\__ESP\esp-wifi_env_sensor\src\HAL_JSON\RuleEngine\HAL_JSON_RULE_Engine_Structures.h", "C++", -132, 0, -33, -165
"g:\_git\__ESP\esp-wifi_env_sensor\src\HAL_JSON\RuleEngine\HAL_JSON_RULE_Engine_Support.h", "C++", 10, 0, 3, 13
"Total", "-", -5, 25, 25, 45