"filename", "language", "C++", "comment", "blank", "total"
"g:\_git\__ESP\esp-wifi_env_sensor\src\Drivers\FAN.h", "C++", 78, 5, 14, 97
"g:\_git\__ESP\esp-wifi_env_sensor\src\Drivers\HearbeatLed.h", "C++", 100, 0, 7, 107
"g:\_git\__ESP\esp-wifi_env_sensor\src\Drivers\REGO600.cpp", "C++", 307, 21, 41, 369
"g:\_git\__ESP\esp-wifi_env_sensor\src\Drivers\REGO600.h", "C++", 118, 19, 32, 169
"g:\_git\__ESP\esp-wifi_env_sensor\src\Drivers\RF433.cpp", "C++", 335, 32, 42, 409
"g:\_git\__ESP\esp-wifi_env_sensor\src\Drivers\RF433.h", "C++", 59, 28, 21, 108
"g:\_git\__ESP\esp-wifi_env_sensor\src\Drivers\UART2websocket.cpp", "C++", 37, 2, 8, 47
"g:\_git\__ESP\esp-wifi_env_sensor\src\Drivers\UART2websocket.h", "C++", 25, 0, 8, 33
"g:\_git\__ESP\esp-wifi_env_sensor\src\Scheduler\Scheduler.cpp", "C++", 231, 41, 43, 315
"g:\_git\__ESP\esp-wifi_env_sensor\src\Scheduler\Scheduler.h", "C++", 65, 0, 14, 79
"g:\_git\__ESP\esp-wifi_env_sensor\src\Services\AWS_IOT.h.old", "C++", 208, 32, 38, 278
"g:\_git\__ESP\esp-wifi_env_sensor\src\Services\NordPoolFetcher.h", "C++", 102, 72, 13, 187
"g:\_git\__ESP\esp-wifi_env_sensor\src\Services\ThingSpeak.h", "C++", 226, 12, 30, 268
"g:\_git\__ESP\esp-wifi_env_sensor\src\Support\CharArrayHelpers.cpp", "C++", 96, 12, 20, 128
"g:\_git\__ESP\esp-wifi_env_sensor\src\Support\CharArrayHelpers.h", "C++", 17, 13, 11, 41
"g:\_git\__ESP\esp-wifi_env_sensor\src\Support\ConstantStrings.cpp", "C++", 4, 0, 2, 6
"g:\_git\__ESP\esp-wifi_env_sensor\src\Support\ConstantStrings.h", "C++", 13, 1, 4, 18
"g:\_git\__ESP\esp-wifi_env_sensor\src\Support\ConvertHelper.cpp", "C++", 179, 8, 25, 212
"g:\_git\__ESP\esp-wifi_env_sensor\src\Support\ConvertHelper.h", "C++", 26, 1, 9, 36
"g:\_git\__ESP\esp-wifi_env_sensor\src\Support\Info.h", "C++", 185, 29, 23, 237
"g:\_git\__ESP\esp-wifi_env_sensor\src\Support\LittleFS_ext.cpp", "C++", 148, 2, 21, 171
"g:\_git\__ESP\esp-wifi_env_sensor\src\Support\LittleFS_ext.h", "C++", 20, 7, 4, 31
"g:\_git\__ESP\esp-wifi_env_sensor\src\Support\Logger.cpp", "C++", 203, 2, 20, 225
"g:\_git\__ESP\esp-wifi_env_sensor\src\Support\Logger.h", "C++", 60, 18, 16, 94
"g:\_git\__ESP\esp-wifi_env_sensor\src\Support\NTP.cpp", "C++", 24, 1, 5, 30
"g:\_git\__ESP\esp-wifi_env_sensor\src\Support\NTP.h", "C++", 14, 3, 8, 25
"g:\_git\__ESP\esp-wifi_env_sensor\src\Support\SliceStack.cpp", "C++", 8, 0, 1, 9
"g:\_git\__ESP\esp-wifi_env_sensor\src\Support\SliceStack.h", "C++", 91, 8, 15, 114
"g:\_git\__ESP\esp-wifi_env_sensor\src\Support\Time_ext.cpp", "C++", 23, 0, 5, 28
"g:\_git\__ESP\esp-wifi_env_sensor\src\Support\Time_ext.h", "C++", 10, 0, 2, 12
"g:\_git\__ESP\esp-wifi_env_sensor\src\Support\fs_WebServer.h", "C++", 41, 21, 3, 65
"g:\_git\__ESP\esp-wifi_env_sensor\src\Support\mimetable.cpp", "C++", 94, 1, 7, 102
"g:\_git\__ESP\esp-wifi_env_sensor\src\Support\mimetable.h", "C++", 44, 0, 9, 53
"g:\_git\__ESP\esp-wifi_env_sensor\src\System\FSBrowser.h", "C++", 403, 135, 95, 633
"g:\_git\__ESP\esp-wifi_env_sensor\src\System\MainConfig.cpp", "C++", 75, 0, 11, 86
"g:\_git\__ESP\esp-wifi_env_sensor\src\System\MainConfig.h", "C++", 32, 0, 5, 37
"g:\_git\__ESP\esp-wifi_env_sensor\src\System\OTA.h", "C++", 81, 20, 28, 129
"g:\_git\__ESP\esp-wifi_env_sensor\src\main.cpp", "C++", 477, 80, 67, 624
"g:\_git\__ESP\esp-wifi_env_sensor\src\main.h", "C++", 64, 22, 35, 121
"Total", "-", 4323, 648, 762, 5733