"filename", "language", "C++", "comment", "blank", "total"
"g:\_git\__ESP\esp-wifi_env_sensor\src\HAL_JSON\Devices\HAL_JSON_DHT.cpp", "C++", 21, 0, 2, 23
"g:\_git\__ESP\esp-wifi_env_sensor\src\HAL_JSON\Devices\HAL_JSON_DHT.h", "C++", 3, 0, 2, 5
"g:\_git\__ESP\esp-wifi_env_sensor\src\HAL_JSON\Devices\HAL_JSON_RuleVariable.cpp", "C++", 2, 0, 0, 2
"g:\_git\__ESP\esp-wifi_env_sensor\src\HAL_JSON\HAL_JSON_CachedDeviceAccess.cpp", "C++", 19, 0, 4, 23
"g:\_git\__ESP\esp-wifi_env_sensor\src\HAL_JSON\HAL_JSON_CachedDeviceAccess.h", "C++", 23, 2, 6, 31
"g:\_git\__ESP\esp-wifi_env_sensor\src\HAL_JSON\HAL_JSON_Device.cpp", "C++", 1, 0, 0, 1
"g:\_git\__ESP\esp-wifi_env_sensor\src\HAL_JSON\HAL_JSON_Device.h", "C++", 2, 1, 3, 6
"g:\_git\__ESP\esp-wifi_env_sensor\src\HAL_JSON\HAL_JSON_Manager.cpp", "C++", 6, -1, 0, 5
"g:\_git\__ESP\esp-wifi_env_sensor\src\HAL_JSON\HAL_JSON_Manager.h", "C++", 2, 0, 1, 3
"g:\_git\__ESP\esp-wifi_env_sensor\src\HAL_JSON\HAL_JSON_UID.cpp", "C++", 59, 7, 10, 76
"g:\_git\__ESP\esp-wifi_env_sensor\src\HAL_JSON\HAL_JSON_UID.h", "C++", 36, 4, 5, 45
"g:\_git\__ESP\esp-wifi_env_sensor\src\HAL_JSON\HAL_JSON_UID_Path.cpp", "C++", 1, -1, -1, -1
"g:\_git\__ESP\esp-wifi_env_sensor\src\HAL_JSON\HAL_JSON_UID_Path.h", "C++", -8, -1, 0, -9
"Total", "-", 167, 11, 32, 210