"filename", "language", "C++", "comment", "blank", "total"
"g:\_git\__ESP\esp-wifi_env_sensor\src\HAL_JSON\RuleEngine\HAL_JSON_RULE_Engine_IfBlock.cpp", "C++", -72, -10, -19, -101
"g:\_git\__ESP\esp-wifi_env_sensor\src\HAL_JSON\RuleEngine\HAL_JSON_RULE_Engine_IfBlock.h", "C++", -46, -21, -20, -87
"g:\_git\__ESP\esp-wifi_env_sensor\src\HAL_JSON\RuleEngine\HAL_JSON_RULE_Engine_IfConditionItem.cpp", "C++", -27, 0, -8, -35
"g:\_git\__ESP\esp-wifi_env_sensor\src\HAL_JSON\RuleEngine\HAL_JSON_RULE_Engine_IfConditionItem.h", "C++", -25, -1, -8, -34
"g:\_git\__ESP\esp-wifi_env_sensor\src\HAL_JSON\RuleEngine\HAL_JSON_RULE_Engine_IfStatement.cpp", "C++", 73, 12, 22, 107
"g:\_git\__ESP\esp-wifi_env_sensor\src\HAL_JSON\RuleEngine\HAL_JSON_RULE_Engine_IfStatement.h", "C++", 49, 23, 20, 92
"g:\_git\__ESP\esp-wifi_env_sensor\src\HAL_JSON\RuleEngine\HAL_JSON_RULE_Engine_LogicExecNode.cpp", "C++", 44, 2, 17, 63
"g:\_git\__ESP\esp-wifi_env_sensor\src\HAL_JSON\RuleEngine\HAL_JSON_RULE_Engine_LogicExecNode.h", "C++", 45, 5, 16, 66
"g:\_git\__ESP\esp-wifi_env_sensor\src\HAL_JSON\RuleEngine\HAL_JSON_RULE_Engine_LogicalExpressionRPNToken.cpp", "C++", -10, 0, -6, -16
"g:\_git\__ESP\esp-wifi_env_sensor\src\HAL_JSON\RuleEngine\HAL_JSON_RULE_Engine_LogicalExpressionRPNToken.h", "C++", -18, -1, -8, -27
"g:\_git\__ESP\esp-wifi_env_sensor\src\HAL_JSON\RuleEngine\HAL_JSON_RULE_Engine_Script.cpp", "C++", 2, 0, 0, 2
"g:\_git\__ESP\esp-wifi_env_sensor\src\HAL_JSON\RuleEngine\HAL_JSON_RULE_Engine_Support.h", "C++", 6, 0, 0, 6
"g:\_git\__ESP\esp-wifi_env_sensor\src\HAL_JSON\RuleEngine\HAL_JSON_RULE_Expression_Parser.cpp", "C++", 100, 24, 15, 139
"g:\_git\__ESP\esp-wifi_env_sensor\src\HAL_JSON\RuleEngine\HAL_JSON_RULE_Expression_Parser.h", "C++", 25, 1, 5, 31
"g:\_git\__ESP\esp-wifi_env_sensor\src\HAL_JSON\RuleEngine\HAL_JSON_RULE_Expression_Token.cpp", "C++", 15, 2, -1, 16
"g:\_git\__ESP\esp-wifi_env_sensor\src\HAL_JSON\RuleEngine\HAL_JSON_RULE_Expression_Token.h", "C++", 4, 0, 0, 4
"g:\_git\__ESP\esp-wifi_env_sensor\src\HAL_JSON\RuleEngine\HAL_JSON_RULE_Parser.cpp", "C++", 1, 8, 2, 11
"Total", "-", 166, 44, 27, 237