"filename", "language", "C++", "comment", "blank", "total"
"g:\_git\__ESP\esp-wifi_env_sensor\src\HAL_JSON\Devices\HAL_JSON_CoreDevices.cpp", "C++", 278, 64, 51, 393
"g:\_git\__ESP\esp-wifi_env_sensor\src\HAL_JSON\Devices\HAL_JSON_CoreDevices.h", "C++", 106, 35, 21, 162
"g:\_git\__ESP\esp-wifi_env_sensor\src\HAL_JSON\Devices\HAL_JSON_DHT.cpp", "C++", 95, 6, 14, 115
"g:\_git\__ESP\esp-wifi_env_sensor\src\HAL_JSON\Devices\HAL_JSON_DHT.h", "C++", 34, 2, 10, 46
"g:\_git\__ESP\esp-wifi_env_sensor\src\HAL_JSON\Devices\HAL_JSON_RuleVariable.cpp", "C++", 37, 2, 8, 47
"g:\_git\__ESP\esp-wifi_env_sensor\src\HAL_JSON\Devices\HAL_JSON_RuleVariable.h", "C++", 21, 0, 5, 26
"g:\_git\__ESP\esp-wifi_env_sensor\src\HAL_JSON\Devices\HAL_JSON_template.cpp", "C++", 23, 1, 8, 32
"g:\_git\__ESP\esp-wifi_env_sensor\src\HAL_JSON\Devices\HAL_JSON_template.h", "C++", 18, 0, 5, 23
"g:\_git\__ESP\esp-wifi_env_sensor\src\HAL_JSON\Devices\OneWireTemp\HAL_JSON_OneWireTemp.h", "C++", 4, 3, 2, 9
"g:\_git\__ESP\esp-wifi_env_sensor\src\HAL_JSON\Devices\OneWireTemp\HAL_JSON_OneWireTempAutoRefresh.cpp", "C++", 43, 5, 8, 56
"g:\_git\__ESP\esp-wifi_env_sensor\src\HAL_JSON\Devices\OneWireTemp\HAL_JSON_OneWireTempAutoRefresh.h", "C++", 30, 0, 15, 45
"g:\_git\__ESP\esp-wifi_env_sensor\src\HAL_JSON\Devices\OneWireTemp\HAL_JSON_OneWireTempBus.cpp", "C++", 222, 8, 33, 263
"g:\_git\__ESP\esp-wifi_env_sensor\src\HAL_JSON\Devices\OneWireTemp\HAL_JSON_OneWireTempBus.h", "C++", 44, 1, 12, 57
"g:\_git\__ESP\esp-wifi_env_sensor\src\HAL_JSON\Devices\OneWireTemp\HAL_JSON_OneWireTempDevice.cpp", "C++", 89, 14, 25, 128
"g:\_git\__ESP\esp-wifi_env_sensor\src\HAL_JSON\Devices\OneWireTemp\HAL_JSON_OneWireTempDevice.h", "C++", 52, 0, 15, 67
"g:\_git\__ESP\esp-wifi_env_sensor\src\HAL_JSON\Devices\OneWireTemp\HAL_JSON_OneWireTempGroup.cpp", "C++", 178, 6, 18, 202
"g:\_git\__ESP\esp-wifi_env_sensor\src\HAL_JSON\Devices\OneWireTemp\HAL_JSON_OneWireTempGroup.h", "C++", 29, 1, 11, 41
"g:\_git\__ESP\esp-wifi_env_sensor\src\HAL_JSON\Devices\REGO600\HAL_JSON_REGO600.cpp", "C++", 102, 3, 10, 115
"g:\_git\__ESP\esp-wifi_env_sensor\src\HAL_JSON\Devices\REGO600\HAL_JSON_REGO600.h", "C++", 28, 1, 5, 34
"g:\_git\__ESP\esp-wifi_env_sensor\src\HAL_JSON\Devices\REGO600\HAL_JSON_REGO600register.cpp", "C++", 58, 4, 11, 73
"g:\_git\__ESP\esp-wifi_env_sensor\src\HAL_JSON\Devices\REGO600\HAL_JSON_REGO600register.h", "C++", 30, 3, 6, 39
"g:\_git\__ESP\esp-wifi_env_sensor\src\HAL_JSON\Devices\RF433\HAL_JSON_TX433.cpp", "C++", 90, 3, 14, 107
"g:\_git\__ESP\esp-wifi_env_sensor\src\HAL_JSON\Devices\RF433\HAL_JSON_TX433.h", "C++", 25, 0, 7, 32
"g:\_git\__ESP\esp-wifi_env_sensor\src\HAL_JSON\Devices\RF433\HAL_JSON_TX433unit.cpp", "C++", 70, 2, 14, 86
"g:\_git\__ESP\esp-wifi_env_sensor\src\HAL_JSON\Devices\RF433\HAL_JSON_TX433unit.h", "C++", 31, 6, 10, 47
"g:\_git\__ESP\esp-wifi_env_sensor\src\HAL_JSON\HAL_JSON.cpp", "C++", 11, 1, 3, 15
"g:\_git\__ESP\esp-wifi_env_sensor\src\HAL_JSON\HAL_JSON.h", "C++", 14, 0, 5, 19
"g:\_git\__ESP\esp-wifi_env_sensor\src\HAL_JSON\HAL_JSON_ArduinoJSON_ext.cpp", "C++", 100, 0, 13, 113
"g:\_git\__ESP\esp-wifi_env_sensor\src\HAL_JSON\HAL_JSON_ArduinoJSON_ext.h", "C++", 25, 0, 9, 34
"g:\_git\__ESP\esp-wifi_env_sensor\src\HAL_JSON\HAL_JSON_Device.cpp", "C++", 34, 0, 12, 46
"g:\_git\__ESP\esp-wifi_env_sensor\src\HAL_JSON\HAL_JSON_Device.h", "C++", 60, 4, 14, 78
"g:\_git\__ESP\esp-wifi_env_sensor\src\HAL_JSON\HAL_JSON_DeviceTypesRegistry.cpp", "C++", 31, 2, 9, 42
"g:\_git\__ESP\esp-wifi_env_sensor\src\HAL_JSON\HAL_JSON_DeviceTypesRegistry.h", "C++", 22, 0, 8, 30
"g:\_git\__ESP\esp-wifi_env_sensor\src\HAL_JSON\HAL_JSON_Device_GlobalDefines.h", "C++", 33, 5, 12, 50
"g:\_git\__ESP\esp-wifi_env_sensor\src\HAL_JSON\HAL_JSON_GPIO_Manager.cpp", "C++", 127, 11, 10, 148
"g:\_git\__ESP\esp-wifi_env_sensor\src\HAL_JSON\HAL_JSON_GPIO_Manager.h", "C++", 45, 15, 13, 73
"g:\_git\__ESP\esp-wifi_env_sensor\src\HAL_JSON\HAL_JSON_GPIO_Manager_REST.cpp", "C++", 82, 0, 4, 86
"g:\_git\__ESP\esp-wifi_env_sensor\src\HAL_JSON\HAL_JSON_GPIO_Manager_REST.h", "C++", 29, 0, 7, 36
"g:\_git\__ESP\esp-wifi_env_sensor\src\HAL_JSON\HAL_JSON_Manager.cpp", "C++", 231, 28, 33, 292
"g:\_git\__ESP\esp-wifi_env_sensor\src\HAL_JSON\HAL_JSON_Manager.h", "C++", 38, 7, 13, 58
"g:\_git\__ESP\esp-wifi_env_sensor\src\HAL_JSON\HAL_JSON_Operations.cpp", "C++", 0, 0, 1, 1
"g:\_git\__ESP\esp-wifi_env_sensor\src\HAL_JSON\HAL_JSON_Operations.h", "C++", 59, 1, 14, 74
"g:\_git\__ESP\esp-wifi_env_sensor\src\HAL_JSON\HAL_JSON_REST.cpp", "C++", 228, 26, 22, 276
"g:\_git\__ESP\esp-wifi_env_sensor\src\HAL_JSON\HAL_JSON_REST.h", "C++", 36, 3, 10, 49
"g:\_git\__ESP\esp-wifi_env_sensor\src\HAL_JSON\HAL_JSON_UID_Path.cpp", "C++", 109, 5, 12, 126
"g:\_git\__ESP\esp-wifi_env_sensor\src\HAL_JSON\HAL_JSON_UID_Path.h", "C++", 52, 7, 13, 72
"g:\_git\__ESP\esp-wifi_env_sensor\src\HAL_JSON\HAL_JSON_Value.cpp", "C++", 91, 13, 27, 131
"g:\_git\__ESP\esp-wifi_env_sensor\src\HAL_JSON\HAL_JSON_Value.h", "C++", 44, 7, 12, 63
"g:\_git\__ESP\esp-wifi_env_sensor\src\HAL_JSON\RuleEngine\HAL_JSON_RULE_Engine.cpp", "C++", 103, 3, 20, 126
"g:\_git\__ESP\esp-wifi_env_sensor\src\HAL_JSON\RuleEngine\HAL_JSON_RULE_Engine.h", "C++", 72, 20, 19, 111
"Total", "-", 3413, 328, 653, 4394