"filename", "language", "C++", "Makefile", "Batch", "JSON", "comment", "blank", "total"
"g:\_git\__ESP\esp-wifi_env_sensor\pc_simulation\HAL_JSON_Manager_WIN.cpp", "C++", -10, 0, 0, 0, -1, -3, -14
"g:\_git\__ESP\esp-wifi_env_sensor\pc_simulation\HAL_JSON_Manager_WIN.h", "C++", -11, 0, 0, 0, -1, -3, -15
"g:\_git\__ESP\esp-wifi_env_sensor\pc_simulation\RPN_tools.cpp", "C++", -100, 0, 0, 0, 0, -19, -119
"g:\_git\__ESP\esp-wifi_env_sensor\pc_simulation\RPN_tools.h", "C++", -11, 0, 0, 0, 0, -4, -15
"g:\_git\__ESP\esp-wifi_env_sensor\pc_simulation\cfg.json", "JSON", 0, 0, 0, -32, 0, 0, -32
"g:\_git\__ESP\esp-wifi_env_sensor\pc_simulation\compile.bat", "Batch", 0, 0, -1, 0, 0, 0, -1
"g:\_git\__ESP\esp-wifi_env_sensor\pc_simulation\main.cpp", "C++", -293, 0, 0, 0, -35, -51, -379
"g:\_git\__ESP\esp-wifi_env_sensor\pc_simulation\main.cpp.old", "C++", -61, 0, 0, 0, -19, -11, -91
"g:\_git\__ESP\esp-wifi_env_sensor\pc_simulation\makefile", "Makefile", 0, -33, 0, 0, -9, -11, -53
"g:\_git\__ESP\esp-wifi_env_sensor\pc_simulation\openCmdPrompts - kopia.bat", "Batch", 0, 0, -14, 0, 0, -1, -15
"g:\_git\__ESP\esp-wifi_env_sensor\pc_simulation\openCmdPrompts.bat", "Batch", 0, 0, -2, 0, 0, 0, -2
"g:\_git\__ESP\esp-wifi_env_sensor\pc_simulation\stubs\Arduino\Arduino.cpp", "C++", -2, 0, 0, 0, 0, -2, -4
"g:\_git\__ESP\esp-wifi_env_sensor\pc_simulation\stubs\Arduino\Arduino.h", "C++", -49, 0, 0, 0, -5, -22, -76
"g:\_git\__ESP\esp-wifi_env_sensor\pc_simulation\stubs\DHTesp\DHTesp.cpp", "C++", -1, 0, 0, 0, 0, -1, -2
"g:\_git\__ESP\esp-wifi_env_sensor\pc_simulation\stubs\DHTesp\DHTesp.h", "C++", 0, 0, 0, 0, 0, -2, -2
"g:\_git\__ESP\esp-wifi_env_sensor\pc_simulation\stubs\DallasTemperature\DallasTemperature.cpp", "C++", -1, 0, 0, 0, 0, -1, -2
"g:\_git\__ESP\esp-wifi_env_sensor\pc_simulation\stubs\DallasTemperature\DallasTemperature.h", "C++", 0, 0, 0, 0, 0, -1, -1
"g:\_git\__ESP\esp-wifi_env_sensor\pc_simulation\stubs\OneWire\OneWire.cpp", "C++", -1, 0, 0, 0, 0, -1, -2
"g:\_git\__ESP\esp-wifi_env_sensor\pc_simulation\stubs\OneWire\OneWire.h", "C++", 0, 0, 0, 0, 0, -1, -1
"g:\_git\__ESP\esp-wifi_env_sensor\pc_simulation\stubs\Stream_WIN.h", "C++", -24, 0, 0, 0, 0, -10, -34
"g:\_git\__ESP\esp-wifi_env_sensor\pc_simulation\stubs\Ticker\Ticker.cpp", "C++", -10, 0, 0, 0, -1, -1, -12
"g:\_git\__ESP\esp-wifi_env_sensor\pc_simulation\stubs\Ticker\Ticker.h", "C++", -18, 0, 0, 0, -1, -5, -24
"g:\_git\__ESP\esp-wifi_env_sensor\src\HAL_JSON\Devices\HAL_JSON_CoreDevices.cpp", "C++", 278, 0, 0, 0, 64, 51, 393
"g:\_git\__ESP\esp-wifi_env_sensor\src\HAL_JSON\Devices\HAL_JSON_CoreDevices.h", "C++", 106, 0, 0, 0, 35, 23, 164
"g:\_git\__ESP\esp-wifi_env_sensor\src\HAL_JSON\Devices\HAL_JSON_DHT.cpp", "C++", 118, 0, 0, 0, 6, 16, 140
"g:\_git\__ESP\esp-wifi_env_sensor\src\HAL_JSON\Devices\HAL_JSON_DHT.h", "C++", 37, 0, 0, 0, 2, 14, 53
"g:\_git\__ESP\esp-wifi_env_sensor\src\HAL_JSON\Devices\HAL_JSON_RuleVariable.cpp", "C++", 39, 0, 0, 0, 2, 8, 49
"g:\_git\__ESP\esp-wifi_env_sensor\src\HAL_JSON\Devices\HAL_JSON_RuleVariable.h", "C++", 21, 0, 0, 0, 0, 7, 28
"g:\_git\__ESP\esp-wifi_env_sensor\src\HAL_JSON\Devices\HAL_JSON_template.cpp", "C++", 23, 0, 0, 0, 1, 8, 32
"g:\_git\__ESP\esp-wifi_env_sensor\src\HAL_JSON\Devices\HAL_JSON_template.h", "C++", 18, 0, 0, 0, 0, 6, 24
"g:\_git\__ESP\esp-wifi_env_sensor\src\HAL_JSON\Devices\OneWireTemp\HAL_JSON_OneWireTemp.h", "C++", 4, 0, 0, 0, 3, 2, 9
"g:\_git\__ESP\esp-wifi_env_sensor\src\HAL_JSON\Devices\OneWireTemp\HAL_JSON_OneWireTempAutoRefresh.cpp", "C++", 43, 0, 0, 0, 5, 8, 56
"g:\_git\__ESP\esp-wifi_env_sensor\src\HAL_JSON\Devices\OneWireTemp\HAL_JSON_OneWireTempAutoRefresh.h", "C++", 31, 0, 0, 0, 0, 17, 48
"g:\_git\__ESP\esp-wifi_env_sensor\src\HAL_JSON\Devices\OneWireTemp\HAL_JSON_OneWireTempBus.cpp", "C++", 219, 0, 0, 0, 12, 33, 264
"g:\_git\__ESP\esp-wifi_env_sensor\src\HAL_JSON\Devices\OneWireTemp\HAL_JSON_OneWireTempBus.h", "C++", 44, 0, 0, 0, 1, 16, 61
"g:\_git\__ESP\esp-wifi_env_sensor\src\HAL_JSON\Devices\OneWireTemp\HAL_JSON_OneWireTempDevice.cpp", "C++", 96, 0, 0, 0, 14, 28, 138
"g:\_git\__ESP\esp-wifi_env_sensor\src\HAL_JSON\Devices\OneWireTemp\HAL_JSON_OneWireTempDevice.h", "C++", 53, 0, 0, 0, 2, 18, 73
"g:\_git\__ESP\esp-wifi_env_sensor\src\HAL_JSON\Devices\OneWireTemp\HAL_JSON_OneWireTempGroup.cpp", "C++", 179, 0, 0, 0, 6, 18, 203
"g:\_git\__ESP\esp-wifi_env_sensor\src\HAL_JSON\Devices\OneWireTemp\HAL_JSON_OneWireTempGroup.h", "C++", 29, 0, 0, 0, 1, 12, 42
"g:\_git\__ESP\esp-wifi_env_sensor\src\HAL_JSON\Devices\REGO600\HAL_JSON_REGO600.cpp", "C++", 102, 0, 0, 0, 3, 10, 115
"g:\_git\__ESP\esp-wifi_env_sensor\src\HAL_JSON\Devices\REGO600\HAL_JSON_REGO600.h", "C++", 28, 0, 0, 0, 1, 6, 35
"g:\_git\__ESP\esp-wifi_env_sensor\src\HAL_JSON\Devices\REGO600\HAL_JSON_REGO600register.cpp", "C++", 58, 0, 0, 0, 4, 11, 73
"g:\_git\__ESP\esp-wifi_env_sensor\src\HAL_JSON\Devices\REGO600\HAL_JSON_REGO600register.h", "C++", 30, 0, 0, 0, 3, 7, 40
"g:\_git\__ESP\esp-wifi_env_sensor\src\HAL_JSON\Devices\RF433\HAL_JSON_TX433.cpp", "C++", 94, 0, 0, 0, 3, 14, 111
"g:\_git\__ESP\esp-wifi_env_sensor\src\HAL_JSON\Devices\RF433\HAL_JSON_TX433.h", "C++", 25, 0, 0, 0, 0, 9, 34
"g:\_git\__ESP\esp-wifi_env_sensor\src\HAL_JSON\Devices\RF433\HAL_JSON_TX433unit.cpp", "C++", 70, 0, 0, 0, 2, 14, 86
"g:\_git\__ESP\esp-wifi_env_sensor\src\HAL_JSON\Devices\RF433\HAL_JSON_TX433unit.h", "C++", 31, 0, 0, 0, 6, 12, 49
"g:\_git\__ESP\esp-wifi_env_sensor\src\HAL_JSON\HAL_JSON.cpp", "C++", 10, 0, 0, 0, 1, 3, 14
"g:\_git\__ESP\esp-wifi_env_sensor\src\HAL_JSON\HAL_JSON.h", "C++", 13, 0, 0, 0, 0, 5, 18
"g:\_git\__ESP\esp-wifi_env_sensor\src\HAL_JSON\HAL_JSON_ArduinoJSON_ext.cpp", "C++", 101, 0, 0, 0, 0, 13, 114
"g:\_git\__ESP\esp-wifi_env_sensor\src\HAL_JSON\HAL_JSON_ArduinoJSON_ext.h", "C++", 25, 0, 0, 0, 0, 11, 36
"g:\_git\__ESP\esp-wifi_env_sensor\src\HAL_JSON\HAL_JSON_CachedDeviceAccess.cpp", "C++", 19, 0, 0, 0, 0, 4, 23
"g:\_git\__ESP\esp-wifi_env_sensor\src\HAL_JSON\HAL_JSON_CachedDeviceAccess.h", "C++", 21, 0, 0, 0, 2, 8, 31
"g:\_git\__ESP\esp-wifi_env_sensor\src\HAL_JSON\HAL_JSON_CommandExecutor.cpp", "C++", 257, 0, 0, 0, 24, 26, 307
"g:\_git\__ESP\esp-wifi_env_sensor\src\HAL_JSON\HAL_JSON_CommandExecutor.h", "C++", 41, 0, 0, 0, 6, 11, 58
"g:\_git\__ESP\esp-wifi_env_sensor\src\HAL_JSON\HAL_JSON_Device.cpp", "C++", 35, 0, 0, 0, 0, 12, 47
"g:\_git\__ESP\esp-wifi_env_sensor\src\HAL_JSON\HAL_JSON_Device.h", "C++", 61, 0, 0, 0, 6, 19, 86
"g:\_git\__ESP\esp-wifi_env_sensor\src\HAL_JSON\HAL_JSON_DeviceTypesRegistry.cpp", "C++", 31, 0, 0, 0, 2, 9, 42
"g:\_git\__ESP\esp-wifi_env_sensor\src\HAL_JSON\HAL_JSON_DeviceTypesRegistry.h", "C++", 22, 0, 0, 0, 0, 10, 32
"g:\_git\__ESP\esp-wifi_env_sensor\src\HAL_JSON\HAL_JSON_Device_GlobalDefines.h", "C++", 42, 0, 0, 0, 5, 14, 61
"g:\_git\__ESP\esp-wifi_env_sensor\src\HAL_JSON\HAL_JSON_GPIO_Manager.cpp", "C++", 213, 0, 0, 0, 13, 16, 242
"g:\_git\__ESP\esp-wifi_env_sensor\src\HAL_JSON\HAL_JSON_GPIO_Manager.h", "C++", 52, 0, 0, 0, 15, 18, 85
"g:\_git\__ESP\esp-wifi_env_sensor\src\HAL_JSON\HAL_JSON_Manager.cpp", "C++", 250, 0, 0, 0, 27, 45, 322
"g:\_git\__ESP\esp-wifi_env_sensor\src\HAL_JSON\HAL_JSON_Manager.h", "C++", 49, 0, 0, 0, 7, 13, 69
"g:\_git\__ESP\esp-wifi_env_sensor\src\HAL_JSON\HAL_JSON_Operations.cpp", "C++", 0, 0, 0, 0, 0, 1, 1
"g:\_git\__ESP\esp-wifi_env_sensor\src\HAL_JSON\HAL_JSON_Operations.h", "C++", 57, 0, 0, 0, 4, 13, 74
"g:\_git\__ESP\esp-wifi_env_sensor\src\HAL_JSON\HAL_JSON_REST.cpp", "C++", 26, 0, 0, 0, 2, 8, 36
"g:\_git\__ESP\esp-wifi_env_sensor\src\HAL_JSON\HAL_JSON_REST.h", "C++", 24, 0, 0, 0, 3, 7, 34
"g:\_git\__ESP\esp-wifi_env_sensor\src\HAL_JSON\HAL_JSON_UID.cpp", "C++", 59, 0, 0, 0, 7, 10, 76
"g:\_git\__ESP\esp-wifi_env_sensor\src\HAL_JSON\HAL_JSON_UID.h", "C++", 32, 0, 0, 0, 4, 7, 43
"g:\_git\__ESP\esp-wifi_env_sensor\src\HAL_JSON\HAL_JSON_UID_Path.cpp", "C++", 110, 0, 0, 0, 4, 11, 125
"g:\_git\__ESP\esp-wifi_env_sensor\src\HAL_JSON\HAL_JSON_UID_Path.h", "C++", 40, 0, 0, 0, 6, 15, 61
"g:\_git\__ESP\esp-wifi_env_sensor\src\HAL_JSON\HAL_JSON_Value.cpp", "C++", 91, 0, 0, 0, 13, 27, 131
"g:\_git\__ESP\esp-wifi_env_sensor\src\HAL_JSON\HAL_JSON_Value.h", "C++", 42, 0, 0, 0, 7, 14, 63
"g:\_git\__ESP\esp-wifi_env_sensor\src\HAL_JSON\RuleEngine\HAL_JSON_RULE_Engine.cpp", "C++", 103, 0, 0, 0, 3, 20, 126
"g:\_git\__ESP\esp-wifi_env_sensor\src\HAL_JSON\RuleEngine\HAL_JSON_RULE_Engine.h", "C++", 66, 0, 0, 0, 20, 24, 110
"g:\_git\__ESP\esp-wifi_env_sensor\src\HAL_JSON\RuleEngine\HAL_JSON_RULE_Expression_Parser.cpp", "C++", 254, 0, 0, 0, 22, 30, 306
"g:\_git\__ESP\esp-wifi_env_sensor\src\HAL_JSON\RuleEngine\HAL_JSON_RULE_Expression_Parser.h", "C++", 34, 0, 0, 0, 1, 7, 42
"g:\_git\__ESP\esp-wifi_env_sensor\src\HAL_JSON\RuleEngine\HAL_JSON_RULE_Parser.cpp", "C++", 487, 0, 0, 0, 26, 58, 571
"g:\_git\__ESP\esp-wifi_env_sensor\src\HAL_JSON\RuleEngine\HAL_JSON_RULE_Parser.h", "C++", 41, 0, 0, 0, 16, 18, 75
"g:\_git\__ESP\esp-wifi_env_sensor\src\HAL_JSON\RuleEngine\HAL_JSON_RULE_Parser_Token.cpp", "C++", 66, 0, 0, 0, 4, 12, 82
"g:\_git\__ESP\esp-wifi_env_sensor\src\HAL_JSON\RuleEngine\HAL_JSON_RULE_Parser_Token.h", "C++", 52, 0, 0, 0, 20, 13, 85
"Total", "-", 4010, -33, -17, -32, 374, 750, 5052