"filename", "language", "C++", "comment", "blank", "total"
"g:\_git\__ESP\esp-wifi_env_sensor\src\HAL_JSON\HAL_JSON_ZeroCopyString.cpp", "C++", 6, 1, 2, 9
"g:\_git\__ESP\esp-wifi_env_sensor\src\HAL_JSON\HAL_JSON_ZeroCopyString.h", "C++", 1, 0, 1, 2
"g:\_git\__ESP\esp-wifi_env_sensor\src\HAL_JSON\RuleEngine\HAL_JSON_RULE_Engine_ActionStatement.cpp", "C++", 9, 0, 4, 13
"g:\_git\__ESP\esp-wifi_env_sensor\src\HAL_JSON\RuleEngine\HAL_JSON_RULE_Engine_ActionStatement.h", "C++", 3, 0, 1, 4
"g:\_git\__ESP\esp-wifi_env_sensor\src\HAL_JSON\RuleEngine\HAL_JSON_RULE_Engine_CalcRPNToken.cpp", "C++", 7, 0, 2, 9
"g:\_git\__ESP\esp-wifi_env_sensor\src\HAL_JSON\RuleEngine\HAL_JSON_RULE_Engine_CalcRPNToken.h", "C++", 1, 0, 0, 1
"g:\_git\__ESP\esp-wifi_env_sensor\src\HAL_JSON\RuleEngine\HAL_JSON_RULE_Engine_IfBlock.cpp", "C++", 64, 10, 16, 90
"g:\_git\__ESP\esp-wifi_env_sensor\src\HAL_JSON\RuleEngine\HAL_JSON_RULE_Engine_IfBlock.h", "C++", 13, 2, 5, 20
"g:\_git\__ESP\esp-wifi_env_sensor\src\HAL_JSON\RuleEngine\HAL_JSON_RULE_Engine_IfConditionItem.cpp", "C++", 4, 0, 3, 7
"g:\_git\__ESP\esp-wifi_env_sensor\src\HAL_JSON\RuleEngine\HAL_JSON_RULE_Engine_IfConditionItem.h", "C++", 1, 0, 0, 1
"g:\_git\__ESP\esp-wifi_env_sensor\src\HAL_JSON\RuleEngine\HAL_JSON_RULE_Engine_LogicalExpressionRPNToken.cpp", "C++", 4, 0, 4, 8
"g:\_git\__ESP\esp-wifi_env_sensor\src\HAL_JSON\RuleEngine\HAL_JSON_RULE_Engine_LogicalExpressionRPNToken.h", "C++", 1, 0, 0, 1
"g:\_git\__ESP\esp-wifi_env_sensor\src\HAL_JSON\RuleEngine\HAL_JSON_RULE_Engine_RPNStack.h", "C++", 1, 0, 0, 1
"g:\_git\__ESP\esp-wifi_env_sensor\src\HAL_JSON\RuleEngine\HAL_JSON_RULE_Engine_Script.cpp", "C++", 87, 10, 22, 119
"g:\_git\__ESP\esp-wifi_env_sensor\src\HAL_JSON\RuleEngine\HAL_JSON_RULE_Engine_Script.h", "C++", 10, 9, 2, 21
"g:\_git\__ESP\esp-wifi_env_sensor\src\HAL_JSON\RuleEngine\HAL_JSON_RULE_Engine_StatementBlock.cpp", "C++", 25, 0, 6, 31
"g:\_git\__ESP\esp-wifi_env_sensor\src\HAL_JSON\RuleEngine\HAL_JSON_RULE_Engine_StatementBlock.h", "C++", 21, 2, 12, 35
"g:\_git\__ESP\esp-wifi_env_sensor\src\HAL_JSON\RuleEngine\HAL_JSON_RULE_Engine_StatementBlock_s.cpp", "C++", -10, 0, -5, -15
"g:\_git\__ESP\esp-wifi_env_sensor\src\HAL_JSON\RuleEngine\HAL_JSON_RULE_Engine_StatementBlock_s.h", "C++", -27, -4, -11, -42
"g:\_git\__ESP\esp-wifi_env_sensor\src\HAL_JSON\RuleEngine\HAL_JSON_RULE_Engine_Support.h", "C++", 4, 0, 0, 4
"g:\_git\__ESP\esp-wifi_env_sensor\src\HAL_JSON\RuleEngine\HAL_JSON_RULE_Expression_Parser.cpp", "C++", 335, 81, 50, 466
"g:\_git\__ESP\esp-wifi_env_sensor\src\HAL_JSON\RuleEngine\HAL_JSON_RULE_Expression_Parser.h", "C++", 69, 6, 19, 94
"g:\_git\__ESP\esp-wifi_env_sensor\src\HAL_JSON\RuleEngine\HAL_JSON_RULE_Parser.cpp", "C++", 108, 166, 39, 313
"g:\_git\__ESP\esp-wifi_env_sensor\src\HAL_JSON\RuleEngine\HAL_JSON_RULE_Parser.h", "C++", 21, 3, 8, 32
"g:\_git\__ESP\esp-wifi_env_sensor\src\HAL_JSON\RuleEngine\HAL_JSON_RULE_Parser_Token.cpp", "C++", 57, 22, 6, 85
"g:\_git\__ESP\esp-wifi_env_sensor\src\HAL_JSON\RuleEngine\HAL_JSON_RULE_Parser_Token.h", "C++", 41, 18, 3, 62
"Total", "-", 856, 326, 189, 1371