"filename", "language", "C++", "comment", "blank", "total"
"g:\_git\__ESP\esp-wifi_env_sensor\src\HAL_JSON\Devices\HAL_JSON_CoreDevices.cpp", "C++", 278, 64, 51, 393
"g:\_git\__ESP\esp-wifi_env_sensor\src\HAL_JSON\Devices\HAL_JSON_CoreDevices.h", "C++", 106, 35, 21, 162
"g:\_git\__ESP\esp-wifi_env_sensor\src\HAL_JSON\Devices\HAL_JSON_DHT.cpp", "C++", 95, 6, 14, 115
"g:\_git\__ESP\esp-wifi_env_sensor\src\HAL_JSON\Devices\HAL_JSON_DHT.h", "C++", 34, 2, 10, 46
"g:\_git\__ESP\esp-wifi_env_sensor\src\HAL_JSON\Devices\HAL_JSON_template.cpp", "C++", 17, 1, 8, 26
"g:\_git\__ESP\esp-wifi_env_sensor\src\HAL_JSON\Devices\HAL_JSON_template.h", "C++", 17, 0, 5, 22
"g:\_git\__ESP\esp-wifi_env_sensor\src\HAL_JSON\Devices\OneWireTemp\HAL_JSON_OneWireTemp.h", "C++", 4, 3, 2, 9
"g:\_git\__ESP\esp-wifi_env_sensor\src\HAL_JSON\Devices\OneWireTemp\HAL_JSON_OneWireTempAutoRefresh.cpp", "C++", 43, 5, 8, 56
"g:\_git\__ESP\esp-wifi_env_sensor\src\HAL_JSON\Devices\OneWireTemp\HAL_JSON_OneWireTempAutoRefresh.h", "C++", 30, 0, 15, 45
"g:\_git\__ESP\esp-wifi_env_sensor\src\HAL_JSON\Devices\OneWireTemp\HAL_JSON_OneWireTempBus.cpp", "C++", 222, 8, 33, 263
"g:\_git\__ESP\esp-wifi_env_sensor\src\HAL_JSON\Devices\OneWireTemp\HAL_JSON_OneWireTempBus.h", "C++", 44, 1, 12, 57
"g:\_git\__ESP\esp-wifi_env_sensor\src\HAL_JSON\Devices\OneWireTemp\HAL_JSON_OneWireTempDevice.cpp", "C++", 89, 14, 25, 128
"g:\_git\__ESP\esp-wifi_env_sensor\src\HAL_JSON\Devices\OneWireTemp\HAL_JSON_OneWireTempDevice.h", "C++", 52, 0, 15, 67
"g:\_git\__ESP\esp-wifi_env_sensor\src\HAL_JSON\Devices\OneWireTemp\HAL_JSON_OneWireTempGroup.cpp", "C++", 178, 6, 18, 202
"g:\_git\__ESP\esp-wifi_env_sensor\src\HAL_JSON\Devices\OneWireTemp\HAL_JSON_OneWireTempGroup.h", "C++", 29, 1, 11, 41
"g:\_git\__ESP\esp-wifi_env_sensor\src\HAL_JSON\Devices\REGO600\HAL_JSON_REGO600.cpp", "C++", 101, 3, 10, 114
"g:\_git\__ESP\esp-wifi_env_sensor\src\HAL_JSON\Devices\REGO600\HAL_JSON_REGO600.h", "C++", 27, 1, 5, 33
"g:\_git\__ESP\esp-wifi_env_sensor\src\HAL_JSON\Devices\REGO600\HAL_JSON_REGO600register.cpp", "C++", 58, 4, 11, 73
"g:\_git\__ESP\esp-wifi_env_sensor\src\HAL_JSON\Devices\REGO600\HAL_JSON_REGO600register.h", "C++", 30, 3, 6, 39
"g:\_git\__ESP\esp-wifi_env_sensor\src\HAL_JSON\Devices\RF433\HAL_JSON_TX433.cpp", "C++", 90, 3, 14, 107
"g:\_git\__ESP\esp-wifi_env_sensor\src\HAL_JSON\Devices\RF433\HAL_JSON_TX433.h", "C++", 25, 0, 7, 32
"g:\_git\__ESP\esp-wifi_env_sensor\src\HAL_JSON\Devices\RF433\HAL_JSON_TX433unit.cpp", "C++", 70, 2, 14, 86
"g:\_git\__ESP\esp-wifi_env_sensor\src\HAL_JSON\Devices\RF433\HAL_JSON_TX433unit.h", "C++", 31, 6, 10, 47
"g:\_git\__ESP\esp-wifi_env_sensor\src\HAL_JSON\GPIO_manager.cpp", "C++", 199, 23, 15, 237
"g:\_git\__ESP\esp-wifi_env_sensor\src\HAL_JSON\GPIO_manager.h", "C++", 52, 20, 10, 82
"g:\_git\__ESP\esp-wifi_env_sensor\src\HAL_JSON\HAL_JSON.cpp", "C++", 449, 54, 53, 556
"g:\_git\__ESP\esp-wifi_env_sensor\src\HAL_JSON\HAL_JSON.h", "C++", 59, 5, 14, 78
"g:\_git\__ESP\esp-wifi_env_sensor\src\HAL_JSON\HAL_JSON_ArduinoJSON_ext.cpp", "C++", 100, 0, 13, 113
"g:\_git\__ESP\esp-wifi_env_sensor\src\HAL_JSON\HAL_JSON_ArduinoJSON_ext.h", "C++", 25, 0, 9, 34
"g:\_git\__ESP\esp-wifi_env_sensor\src\HAL_JSON\HAL_JSON_Device.cpp", "C++", 34, 0, 12, 46
"g:\_git\__ESP\esp-wifi_env_sensor\src\HAL_JSON\HAL_JSON_Device.h", "C++", 60, 4, 14, 78
"g:\_git\__ESP\esp-wifi_env_sensor\src\HAL_JSON\HAL_JSON_DeviceTypesRegistry.cpp", "C++", 29, 2, 9, 40
"g:\_git\__ESP\esp-wifi_env_sensor\src\HAL_JSON\HAL_JSON_DeviceTypesRegistry.h", "C++", 22, 0, 8, 30
"g:\_git\__ESP\esp-wifi_env_sensor\src\HAL_JSON\HAL_JSON_Device_GlobalDefines.h", "C++", 33, 5, 12, 50
"g:\_git\__ESP\esp-wifi_env_sensor\src\HAL_JSON\HAL_JSON_Manager.cpp", "C++", 1, 0, 1, 2
"g:\_git\__ESP\esp-wifi_env_sensor\src\HAL_JSON\HAL_JSON_Manager.h", "C++", 0, 0, 1, 1
"g:\_git\__ESP\esp-wifi_env_sensor\src\HAL_JSON\HAL_JSON_Operations.cpp", "C++", 0, 0, 1, 1
"g:\_git\__ESP\esp-wifi_env_sensor\src\HAL_JSON\HAL_JSON_Operations.h", "C++", 55, 0, 11, 66
"g:\_git\__ESP\esp-wifi_env_sensor\src\HAL_JSON\HAL_JSON_REST.cpp", "C++", 1, 0, 1, 2
"g:\_git\__ESP\esp-wifi_env_sensor\src\HAL_JSON\HAL_JSON_REST.h", "C++", 0, 0, 1, 1
"g:\_git\__ESP\esp-wifi_env_sensor\src\HAL_JSON\HAL_JSON_UID_Path.cpp", "C++", 109, 5, 12, 126
"g:\_git\__ESP\esp-wifi_env_sensor\src\HAL_JSON\HAL_JSON_UID_Path.h", "C++", 47, 7, 13, 67
"g:\_git\__ESP\esp-wifi_env_sensor\src\HAL_JSON\HAL_JSON_Value.cpp", "C++", 65, 13, 18, 96
"g:\_git\__ESP\esp-wifi_env_sensor\src\HAL_JSON\HAL_JSON_Value.h", "C++", 34, 4, 12, 50
"Total", "-", 3044, 310, 565, 3919